11111111111111111111111
10000000000PE00000C0001
11111111111111111111111