111111111111111111111111111111111111111111111111111111111111111111111111111111111111111111111111
100000000000000000000000000000011001000000000000000100000000000110010000000000000001000000000001
100000000000000000000000000000011001000000000000000100000000000110010000000000000001000000000001
1000000000000E0000000000000000011001000000000000000100000000000110010000000000000001000000000001
101001010010000010100100000101011001000000000000000100000000000110010000000000000001000000000001
1010010010101010C0100000000101011001000000000000000100000000000110010000000000000001000000000001
1000000000000C0000000000000000011001000000000000000100000000000110010000000000000001000000000001
10000000000C000000000001000000011001000000000000000100000000000110010000000000000001000000000001
100000000000000E00000000000000011001000000000000000100000000000110010000000000000001000000000001
100100000010000001000000000000011001000000000000000100000000000110010000000000000001000000000001
100000000000000000000000000000011001000000000000000100000000000110010000000000000001000000000001
100100000000000000010000000000011001000000000000000100000000000110010000000000000001000000000001
100100000000000000010000000000011001000000000000000000000000000000000000000000000000000000000001
100100000000000000010000000000011001000000000000000000000000000000000000000000000000000000000001
10010000000E000000010000000000011001000000000000000100000000000110010000000000000001000000000001
100100000000000000010000000000011001000000000000000100000000000110010000000000000001000000000001
100100000000000000010000000000011001000000000000000100000000000110010000000000000001000000000001
100100000000000000010000000000000000000000000000000100000000000110010000000000000001000000000001
100100000000000000010000000000000000000000000000000100000000000110010000000000000001000000000001
100100000000000000010000000000011001000000000000000100000000000110010000000000000001000000000001
100100000000000000010000000000011001000000000000000100000000000110010000000000000001000000000001
100100000000000000010000000000011001000000000000000100000000000110010000000000000001000000000001
100100000000000000010000000000011001000000000000000100000000000110010000000000000001000000000001
1001000000000000000100C0000000011001000000000000000100000000000110010000000000000001000000000001
100100000000000000010000000000011001000000000000000100000000000110010000000000000001000000000001
100100000000000000010000000000011001000000000000000100000000000110010000000000000001000000000001
10010000000000000001000P000000011001000000000000000100000000000110010000000000000001000000000001
100100000000000000010000000000011001000000000000000100000000000110010000000000000001000000000001
100100000000000000010000000000011001000000000000000100000000000110010000000000000001000000000001
100100000000000000010000000000011001000000000000000100000000000110010000000000000001000000000001
100100000000000000010000000000011001000000000000000100000000000110010000000000000001000000000001
111111111111111111111111111111111111111111111111111111111111111111111111111111111111111111111111