11111111111111111111111111111111
100000000000000C00000C0000000001
10000000000000000000000000000001
100000000000000000000000000<0001
1010010100100E001010010000010101
10100100101010100010000000010101
10000000000000000000000000000001
1P0000000C00C00000000001000000C1
10000000000000000000^00000000001
100100000010000001000v0000000001
100000000C0000000000000000000001
1001>000000000000001000000000001
10000000000000000000000000000001
11111111111111111111111111111111