11111111111111111111111111111111111111111111111111111111111111111111111111111111111111111111111111
10000000000000000000000000000001100100000000000000010000000000011001000000000000000100000000000001
10000000000000000000000000000001100100000000000000010000000000011001000000000000000100000000000001
10000000000000000000000000000001100100000000000000010000000000011001000000000000000100000000000001
10100101001000001010010000010101100100000000000000010000000000011001000000000000000100000000000001
10100100101010100010000000010101100100000000000000010000000000011001000000000000000100000000000001
10000000000000000000000000000001100100000000000000010000000000011001000000000000000100000000000001
10000000000000000000000100000001100100000000000000010000000000011001000000000000000100000000000001
10000000000000000000000000000001100100000000000000010000000000011001000000000000000100000000000001
10010000001000000100000000000001100100000000000000010000000000011001000000000000000100000000000001
10000000000000000000000000000001100100000000000000010000000000011001000000000000000100000000000001
10010000000000000001000000000001100100000000000000010000000000011001000000000000000100000000000001
10010000000000000001000000000001100100000000000000000000000000000000000000000000000100000000000001
10010000000000000001000000000001100100000000000000000000000000000000000000000000000100000000000001
10010000000000000001000000000001100100000000000000010000000000011001000000000000000100000000000001
10010000000000000001000000000001100100000000000000010000000000011001000000000000000100000000000001
10010000000000000001000000000001100100000000000000010000000000011001000000000000000100000000000001
10010000000000000001000000000000000000000000000000010000000000011001000000000000000100000000000001
10010000000000000001000000000000000000000000000000010000000000011001000000000000000100000000000001
10010000000000000001000000000001100100000000000000010000000000011001000000000000000100000000000001
10010000000000000001000000000001100100000000000000010000000000011001000000000000000100000000000001
10010000000000000001000000000001100100000000000000010000000000011001000000000000000100000000000001
10010000000000000001000000000001100100000000000000010000000000011001000000000000000100000000000001
100100000000000000010EC000000001100100000000000000010000000000011001000000000000000100000000000001
10010000000000000001000000000001100100000000000000010000000000011001000000000000000100000000000001
1001000000000000000100000P000001100100000000000000010000000000011001000000000000000100000000000001
10010000000000000001000000000001100100000000000000010000000000011001000000000000000100000000000001
10010000000000000001000000000001100100000000000000010000000000011001000000000000000100000000000001
10010000000000000001000000000001100100000000000000010000000000011001000000000000000100000000000001
10010000000000000001000000000001100100000000000000010000000000011001000000000000000100000000000001
10010000000000000001000000000001100100000000000000010000000000011001000000000000000100000000000001
11111111111111111111111111111111111111111111111111111111111111111111111111111111111111111111111111